//MAP CONVERTED BY dmm2tgm.py THIS HEADER COMMENT PREVENTS RECONVERSION, DO NOT REMOVE
"a" = (
/turf/closed/wall/mineral,
/area/pocket_dimension/werewolf_lair)
"b" = (
/turf/open/floor/dirt/road,
/area/pocket_dimension/werewolf_lair)
"c" = (
/obj/structure/fake_machine/contractledger/antag/werewolf,
/turf/open/floor/dirt/road,
/area/pocket_dimension/werewolf_lair)
"d" = (
/obj/effect/landmark/pocket_dimension/entry,
/obj/effect/landmark/pocket_dimension/drop_spot,
/turf/open/floor/dirt/road,
/area/pocket_dimension/werewolf_lair)
"e" = (
/obj/effect/landmark/pocket_dimension/exit,
/turf/open/floor/dirt/road,
/area/pocket_dimension/werewolf_lair)

(1,1,1) = {"
a
a
a
a
a
a
a
"}
(2,1,1) = {"
a
b
b
b
b
b
a
"}
(3,1,1) = {"
a
b
b
c
b
b
a
"}
(4,1,1) = {"
a
b
b
d
b
b
a
"}
(5,1,1) = {"
a
b
b
b
b
b
a
"}
(6,1,1) = {"
a
b
b
e
b
b
a
"}
(7,1,1) = {"
a
a
a
a
a
a
a
"}
