//MAP CONVERTED BY dmm2tgm.py THIS HEADER COMMENT PREVENTS RECONVERSION, DO NOT REMOVE
"a" = (
/turf/closed/mineral/bedrock,
/area/pocket_dimension/werewolf_lair_trap)
"b" = (
/obj/effect/decal/cleanable/blood,
/turf/open/floor/naturalstone,
/area/pocket_dimension/werewolf_lair_trap)
"c" = (
/obj/effect/landmark/pocket_dimension/drop_spot,
/obj/structure/bed/shit,
/turf/open/floor/naturalstone,
/area/pocket_dimension/werewolf_lair_trap)
"d" = (
/obj/effect/landmark/pocket_dimension/entry,
/turf/open/floor/naturalstone,
/area/pocket_dimension/werewolf_lair_trap)
"g" = (
/obj/effect/decal/cleanable/blood,
/obj/structure/stalagmite,
/turf/open/floor/naturalstone,
/area/pocket_dimension/werewolf_lair_trap)
"n" = (
/obj/structure/kneestingers,
/turf/closed/mineral/bedrock,
/area/pocket_dimension/werewolf_lair_trap)
"H" = (
/obj/effect/landmark/pocket_dimension/exit/werewolf,
/turf/closed/mineral/bedrock,
/area/pocket_dimension/werewolf_lair_trap)
"O" = (
/mob/living/simple_animal/hostile/werewolf,
/turf/open/floor/naturalstone,
/area/pocket_dimension/werewolf_lair_trap)

(1,1,1) = {"
a
a
a
a
a
"}
(2,1,1) = {"
a
O
b
O
a
"}
(3,1,1) = {"
n
g
c
d
H
"}
(4,1,1) = {"
n
O
b
O
a
"}
(5,1,1) = {"
a
a
a
n
a
"}
