//MAP CONVERTED BY dmm2tgm.py THIS HEADER COMMENT PREVENTS RECONVERSION, DO NOT REMOVE
"dI" = (
/obj/structure/fluff/railing/corner/north_east,
/turf/open/floor/ruinedwood,
/area/indoors/town/rmh)
"eI" = (
/obj/item/bin/water/gross,
/turf/open/floor/cobblerock,
/area/outdoors/town/rmh)
"eY" = (
/obj/structure/flora/grass,
/turf/open/floor/grass/healthy,
/area/outdoors/town/rmh)
"fa" = (
/turf/open/openspace,
/area/indoors/town/rmh)
"fm" = (
/turf/open/floor/dirt/road,
/area/outdoors/town/rmh)
"fG" = (
/obj/structure/table/wood/large/corner_new{
	dir = 10
	},
/turf/open/floor/ruinedwood/spiralfade,
/area/indoors/town/rmh)
"iw" = (
/obj/structure/fluff/railing/corner/south_east,
/obj/machinery/light/fueled/wallfire/candle/l,
/turf/open/floor/ruinedwood,
/area/indoors/town/rmh)
"iL" = (
/obj/structure/table/wood/large/corner_new{
	dir = 6
	},
/turf/open/floor/ruinedwood,
/area/indoors/town/rmh)
"iW" = (
/obj/machinery/light/fueled/wallfire/candle/l,
/turf/open/floor/ruinedwood/spiral,
/area/indoors/town/rmh)
"kJ" = (
/obj/effect/decal/edge_corner{
	dir = 4;
	color = "#522f26"
	},
/turf/open/floor/blocks/stonered,
/area/indoors/town/rmh)
"kM" = (
/turf/open/floor/grass/healthy,
/area/outdoors/town/rmh)
"mY" = (
/turf/closed/wall/mineral/craftstone,
/area/indoors/town/rmh)
"nH" = (
/obj/structure/stairs{
	dir = 2
	},
/turf/open/floor/ruinedwood/spiralfade,
/area/indoors/town/rmh)
"oJ" = (
/obj/structure/fermentation_keg/water,
/turf/open/floor/ruinedwood/spiralfade,
/area/indoors/town/rmh)
"pA" = (
/obj/structure/window/openclose/reinforced,
/obj/structure/curtain/dir{
	dir = 2;
	color = "#8a6b6b"
	},
/turf/open/floor/ruinedwood,
/area/indoors/town/rmh)
"rI" = (
/turf/open/floor/ruinedwood/spiral,
/area/indoors/town/rmh)
"rY" = (
/obj/structure/bookcase/random_recipes{
	density = 0;
	opacity = 0;
	pixel_x = 32
	},
/turf/open/floor/ruinedwood,
/area/indoors/town/rmh)
"sX" = (
/turf/open/floor/ruinedwood/spiralfade,
/area/indoors/town/rmh)
"tr" = (
/obj/effect/decal/edge_corner{
	dir = 1;
	color = "#522f26";
	pixel_y = 0
	},
/turf/open/floor/blocks/stonered,
/area/indoors/town/rmh)
"ty" = (
/obj/structure/closet/crate/chest/wicker,
/obj/item/reagent_containers/food/snacks/produce/grain/wheat,
/obj/item/reagent_containers/food/snacks/produce/grain/wheat,
/obj/item/reagent_containers/food/snacks/produce/grain/wheat,
/obj/item/reagent_containers/food/snacks/produce/grain/wheat,
/obj/item/reagent_containers/food/snacks/meat/steak,
/obj/item/reagent_containers/food/snacks/meat/steak,
/obj/item/reagent_containers/food/snacks/produce/vegetable/cabbage,
/obj/item/reagent_containers/food/snacks/produce/vegetable/potato,
/obj/item/reagent_containers/food/snacks/produce/vegetable/potato,
/obj/item/reagent_containers/food/snacks/produce/vegetable/potato,
/obj/item/reagent_containers/food/snacks/produce/vegetable/onion,
/obj/item/reagent_containers/food/snacks/produce/vegetable/onion,
/obj/machinery/light/fueled/wallfire/candle/r,
/turf/open/floor/ruinedwood/spiral,
/area/indoors/town/rmh)
"tW" = (
/obj/machinery/light/fueled/wallfire/candle/weak/l,
/turf/open/floor/ruinedwood/herringbone,
/area/indoors/town/rmh)
"va" = (
/obj/effect/decal/edge{
	dir = 4;
	color = "#522f26"
	},
/turf/open/floor/blocks/stonered/tiny,
/area/indoors/town/rmh)
"wl" = (
/turf/closed/wall/mineral/wooddark/horizontal,
/area/indoors/town/rmh)
"wD" = (
/obj/structure/table/wood/large/corner_new{
	dir = 10
	},
/turf/open/floor/ruinedwood,
/area/indoors/town/rmh)
"wE" = (
/obj/structure/rack/shelf,
/obj/item/storage/sack{
	pixel_y = 41;
	pixel_x = 4
	},
/obj/item/storage/sack{
	pixel_y = 40;
	pixel_x = -6
	},
/turf/open/floor/ruinedwood/spiralfade,
/area/indoors/town/rmh)
"xC" = (
/obj/machinery/light/fueled/wallfire/candle{
	pixel_y = -32
	},
/turf/open/floor/ruinedwood/spiralfade,
/area/indoors/town/rmh)
"ye" = (
/turf/closed/wall/mineral/wooddark/end{
	dir = 8
	},
/area/indoors/town/rmh)
"yI" = (
/obj/structure/stairs{
	dir = 2
	},
/turf/open/floor/ruinedwood,
/area/indoors/town/rmh)
"zk" = (
/obj/structure/door/weak/bolt{
	dir = 4
	},
/turf/open/floor/ruinedwood/spiral,
/area/indoors/town/rmh)
"Ca" = (
/turf/closed/wall/mineral/decowood,
/area/indoors/town/rmh)
"Cj" = (
/turf/open/floor/ruinedwood/herringbone,
/area/indoors/town/rmh)
"CG" = (
/obj/structure/fluff/railing/border,
/obj/structure/bookcase/random_recipes{
	density = 0;
	opacity = 0;
	pixel_x = 32
	},
/turf/open/floor/ruinedwood,
/area/indoors/town/rmh)
"Gz" = (
/obj/structure/fluff/railing/border/east,
/turf/open/floor/ruinedwood,
/area/indoors/town/rmh)
"IM" = (
/obj/effect/decal/edge_corner{
	dir = 2;
	color = "#522f26";
	pixel_y = 0
	},
/obj/structure/table/wood/reinf_long,
/turf/open/floor/blocks/stonered,
/area/indoors/town/rmh)
"Jh" = (
/obj/structure/window,
/obj/structure/curtain/dir{
	dir = 2;
	color = "#8a6b6b"
	},
/turf/open/floor/ruinedwood,
/area/indoors/town/rmh)
"Kl" = (
/obj/effect/decal/edge{
	dir = 8;
	color = "#522f26"
	},
/turf/open/floor/blocks/stonered/tiny,
/area/indoors/town/rmh)
"Kv" = (
/obj/effect/decal/edge_corner{
	dir = 8;
	color = "#522f26";
	pixel_y = 0
	},
/turf/open/floor/blocks/stonered,
/area/indoors/town/rmh)
"LS" = (
/turf/open/floor/ruinedwood,
/area/indoors/town/rmh)
"Mr" = (
/obj/structure/door{
	lockid = "housing6";
	name = "C-House VI"
	},
/turf/open/floor/concrete,
/area/indoors/town/rmh)
"Nd" = (
/turf/open/floor/cobblerock,
/area/outdoors/town/rmh)
"Om" = (
/obj/structure/sign/property_sign/claim,
/turf/closed/wall/mineral/wooddark/horizontal,
/area/indoors/town/rmh)
"Pi" = (
/obj/machinery/light/fueled/wallfire/candle/l,
/turf/open/floor/ruinedwood/spiralfade,
/area/indoors/town/rmh)
"PC" = (
/obj/structure/fluff/railing/wood/west,
/obj/effect/decal/cobbleedge{
	dir = 8;
	icon_state = "borderfall";
	pixel_y = 0;
	icon = 'icons/turf/constructed/misc.dmi'
	},
/turf/open/floor/ruinedwood,
/area/indoors/town/rmh)
"QA" = (
/turf/closed/wall/mineral/wooddark,
/area/indoors/town/rmh)
"RG" = (
/obj/machinery/light/fueled/wallfire/candle/r,
/turf/open/floor/ruinedwood/spiralfade,
/area/indoors/town/rmh)
"Sl" = (
/obj/structure/stairs{
	dir = 8
	},
/obj/structure/fluff/railing/wood/north{
	plane = -6;
	pixel_y = 13
	},
/turf/open/floor/ruinedwood,
/area/indoors/town/rmh)
"Ug" = (
/obj/structure/door/weak/bolt{
	dir = 8
	},
/turf/open/floor/ruinedwood/spiral,
/area/indoors/town/rmh)
"Ut" = (
/obj/structure/table/wood/large/corner_new{
	dir = 6
	},
/turf/open/floor/ruinedwood/spiralfade,
/area/indoors/town/rmh)
"US" = (
/obj/effect/decal/edge{
	dir = 8;
	color = "#522f26"
	},
/obj/structure/table/wood/reinf_long{
	dir = 1
	},
/obj/structure/fluff/millstone{
	pixel_y = 12;
	pixel_x = -5
	},
/turf/open/floor/blocks/stonered/tiny,
/area/indoors/town/rmh)
"VT" = (
/turf/closed/wall/mineral/wooddark/vertical,
/area/indoors/town/rmh)
"Yv" = (
/obj/machinery/light/fueled/hearth,
/obj/machinery/light/fueled/oven/east,
/turf/open/floor/cobblerock,
/area/indoors/town/rmh)
"Zj" = (
/obj/structure/closet/crate/crafted_closet/inn/south,
/turf/open/floor/ruinedwood/spiralfade,
/area/indoors/town/rmh)
"ZK" = (
/obj/machinery/light/fueled/wallfire/candle{
	pixel_y = -32
	},
/turf/open/floor/ruinedwood,
/area/indoors/town/rmh)

(1,1,1) = {"
eY
QA
wl
wl
mY
Yv
mY
wl
QA
"}
(2,1,1) = {"
eY
Jh
sX
Pi
Kv
Kl
US
IM
VT
"}
(3,1,1) = {"
eI
wl
wE
sX
tr
va
va
kJ
VT
"}
(4,1,1) = {"
fm
Mr
sX
sX
sX
fG
sX
xC
VT
"}
(5,1,1) = {"
Nd
Om
Zj
sX
sX
Ut
QA
zk
VT
"}
(6,1,1) = {"
kM
Jh
oJ
RG
sX
nH
ye
ty
VT
"}
(7,1,1) = {"
fm
QA
wl
wl
wl
wl
wl
wl
QA
"}

(1,1,2) = {"
QA
Ca
QA
wl
QA
wl
wl
wl
QA
"}
(2,1,2) = {"
Ca
Cj
tW
Cj
VT
rI
iW
rI
VT
"}
(3,1,2) = {"
pA
Cj
Cj
Cj
VT
rI
rI
rI
VT
"}
(4,1,2) = {"
Ca
PC
PC
Sl
QA
wl
Ug
wl
QA
"}
(5,1,2) = {"
pA
wD
LS
LS
iw
Gz
Gz
dI
VT
"}
(6,1,2) = {"
Ca
iL
LS
rY
CG
fa
yI
ZK
VT
"}
(7,1,2) = {"
QA
Ca
QA
wl
wl
wl
wl
wl
QA
"}
