//MAP CONVERTED BY dmm2tgm.py THIS HEADER COMMENT PREVENTS RECONVERSION, DO NOT REMOVE
"a" = (
/turf/closed/wall/mineral/decowood,
/area/indoors/town/rmh)
"b" = (
/turf/closed/wall/mineral/roofwall/outercorner{
	dir = 8
	},
/area/indoors/town/rmh)
"c" = (
/obj/machinery/light/fueled/wallfire/candle/l{
	pixel_y = -32
	},
/turf/open/floor/ruinedwood/spiral,
/area/indoors/town/rmh)
"d" = (
/obj/structure/fluff/railing/wood/east,
/turf/open/floor/twig,
/area/indoors/town/rmh)
"e" = (
/obj/structure/ladder,
/turf/open/floor/ruinedwood/spiral,
/area/indoors/town/rmh)
"f" = (
/turf/closed/wall/mineral/roofwall/middle,
/area/indoors/town/rmh)
"g" = (
/obj/structure/window/openclose/reinforced{
	dir = 1
	},
/obj/structure/fluff/railing/border/west,
/obj/structure/fluff/railing/border/east,
/turf/open/floor/ruinedwood,
/area/indoors/town/rmh)
"h" = (
/turf/closed/wall/mineral/wooddark/vertical,
/area/indoors/town/rmh)
"i" = (
/obj/structure/giantfur/small{
	layer = 2;
	plane = -9;
	pixel_x = -6
	},
/turf/open/floor/ruinedwood/spiral,
/area/indoors/town/rmh)
"k" = (
/obj/structure/rack/shelf/biggest,
/obj/item/reagent_containers/glass/bucket/wooden/alter,
/obj/item/broom,
/turf/open/floor/ruinedwood/spiral,
/area/indoors/town/rmh)
"l" = (
/turf/open/floor/carpet/royalblack,
/area/indoors/town/rmh)
"m" = (
/turf/closed/wall/mineral/roofwall/middle{
	dir = 1
	},
/area/indoors/town/rmh)
"o" = (
/obj/structure/fluff/railing/wood/east,
/obj/structure/closet/crate/chest/old_crate,
/obj/item/plate/clay,
/obj/item/plate/clay,
/obj/item/kitchen/fork,
/obj/item/kitchen/fork,
/obj/item/kitchen/spoon,
/obj/item/kitchen/spoon,
/obj/item/reagent_containers/glass/cup/wooden{
	pixel_x = 6
	},
/turf/open/floor/twig,
/area/indoors/town/rmh)
"p" = (
/obj/effect/decal/edge_corner{
	dir = 8;
	color = "#522f26";
	pixel_y = 0
	},
/obj/effect/decal/edge{
	dir = 4;
	color = "#522f26"
	},
/obj/item/reagent_containers/glass/bucket/wooden/alter{
	pixel_x = -9;
	pixel_y = 4
	},
/turf/open/floor/tile/brick,
/area/indoors/town/rmh)
"q" = (
/obj/structure/closet/crate/drawer,
/obj/item/flint,
/turf/open/floor/carpet/royalblack,
/area/indoors/town/rmh)
"r" = (
/obj/structure/fluff/railing/wood/east,
/turf/open/floor/carpet/royalblack,
/area/indoors/town/rmh)
"s" = (
/turf/closed/wall/mineral/craftstone,
/area/outdoors/rmh_air)
"t" = (
/obj/structure/table/wood/plain/alto,
/obj/item/reagent_containers/glass/bowl{
	pixel_x = -6;
	pixel_y = -2
	},
/obj/item/reagent_containers/glass/bowl{
	pixel_y = -4;
	pixel_x = 11
	},
/obj/item/candle/tin/lit{
	pixel_y = 10
	},
/turf/open/floor/ruinedwood/spiral,
/area/indoors/town/rmh)
"u" = (
/turf/closed/wall/mineral/roofwall/middle{
	dir = 4
	},
/area/indoors/town/rmh)
"x" = (
/obj/structure/window/openclose/reinforced{
	dir = 2
	},
/obj/structure/fluff/railing/border/west,
/obj/structure/fluff/railing/border/east,
/turf/open/floor/ruinedwood,
/area/indoors/town/rmh)
"y" = (
/turf/closed/wall/mineral/craftstone,
/area/indoors/town/rmh)
"z" = (
/obj/effect/decal/edge_corner{
	dir = 2;
	color = "#522f26";
	pixel_y = 0
	},
/obj/effect/decal/edge{
	dir = 5;
	color = "#522f26"
	},
/turf/open/floor/tile/brick,
/area/indoors/town/rmh)
"A" = (
/obj/structure/sign/property_sign/claim,
/turf/closed/wall/mineral/wooddark/vertical,
/area/indoors/town/rmh)
"B" = (
/obj/structure/fermentation_keg/random/water,
/obj/machinery/light/fueled/wallfire/candle/r{
	pixel_y = -32
	},
/turf/open/floor/ruinedwood/spiral,
/area/indoors/town/rmh)
"C" = (
/obj/structure/door{
	lockid = "housing3";
	name = "C-House III"
	},
/turf/open/floor/ruinedwood/darker,
/area/indoors/town/rmh)
"D" = (
/obj/structure/ladder,
/turf/open/floor/twig,
/area/indoors/town/rmh)
"F" = (
/turf/closed/wall/mineral/wooddark,
/area/indoors/town/rmh)
"G" = (
/obj/structure/window/openclose/reinforced{
	dir = 1
	},
/obj/structure/curtain/dir{
	dir = 1;
	color = "#8a6b6b"
	},
/turf/open/floor/ruinedwood,
/area/indoors/town/rmh)
"H" = (
/turf/open/floor/rooftop{
	dir = 1
	},
/area/outdoors/rmh_air)
"I" = (
/obj/structure/closet/crate/chest/wicker,
/obj/item/reagent_containers/food/snacks/produce/grain/wheat,
/obj/item/reagent_containers/food/snacks/produce/grain/wheat,
/obj/item/reagent_containers/food/snacks/produce/grain/wheat,
/obj/item/reagent_containers/food/snacks/produce/grain/wheat,
/obj/item/reagent_containers/food/snacks/meat/steak,
/obj/item/reagent_containers/food/snacks/meat/steak,
/obj/item/reagent_containers/food/snacks/produce/vegetable/cabbage,
/obj/item/reagent_containers/food/snacks/produce/vegetable/potato,
/obj/item/reagent_containers/food/snacks/produce/vegetable/potato,
/obj/item/reagent_containers/food/snacks/produce/vegetable/potato,
/obj/item/reagent_containers/food/snacks/produce/vegetable/onion,
/obj/item/reagent_containers/food/snacks/produce/vegetable/onion,
/turf/open/floor/twig,
/area/indoors/town/rmh)
"J" = (
/obj/effect/decal/edge_corner{
	dir = 4;
	color = "#522f26"
	},
/obj/effect/decal/edge{
	dir = 9;
	color = "#522f26"
	},
/turf/open/floor/tile/brick,
/area/indoors/town/rmh)
"K" = (
/obj/effect/decal/edge_corner{
	dir = 1;
	color = "#522f26";
	pixel_y = 0
	},
/obj/effect/decal/edge{
	dir = 8;
	color = "#522f26"
	},
/obj/structure/table/wood/reinforced_alter,
/obj/structure/fluff/millstone{
	pixel_y = 18;
	pixel_x = 8
	},
/obj/item/weapon/knife/villager,
/obj/machinery/light/fueled/wallfire/candle/r{
	pixel_y = 32
	},
/obj/item/reagent_containers/glass/cup/wooden{
	pixel_x = 6
	},
/turf/open/floor/tile/brick,
/area/indoors/town/rmh)
"L" = (
/turf/closed/wall/mineral/roofwall/outercorner{
	dir = 1
	},
/area/indoors/town/rmh)
"N" = (
/turf/closed/wall/mineral/roofwall/outercorner,
/area/indoors/town/rmh)
"O" = (
/obj/machinery/light/fueled/wallfire/candle/l,
/turf/open/floor/ruinedwood/spiral,
/area/indoors/town/rmh)
"P" = (
/obj/structure/chair/stool/bar,
/turf/open/floor/ruinedwood/spiral,
/area/indoors/town/rmh)
"Q" = (
/turf/closed/wall/mineral/roofwall/outercorner{
	dir = 4
	},
/area/indoors/town/rmh)
"R" = (
/turf/open/floor/ruinedwood/spiral,
/area/indoors/town/rmh)
"S" = (
/turf/open/openspace,
/area/indoors/town/rmh)
"T" = (
/obj/effect/decal/edge{
	dir = 2;
	color = "#522f26"
	},
/obj/effect/decal/edge{
	dir = 1;
	color = "#522f26"
	},
/turf/open/floor/tile/brick,
/area/indoors/town/rmh)
"U" = (
/obj/structure/window/openclose/reinforced{
	dir = 2
	},
/obj/structure/curtain/dir{
	dir = 2;
	color = "#8a6b6b"
	},
/turf/open/floor/ruinedwood,
/area/indoors/town/rmh)
"V" = (
/obj/machinery/light/fueled/hearth,
/obj/item/reagent_containers/glass/bucket/pot,
/obj/machinery/light/fueled/oven/south,
/turf/open/floor/cobblerock,
/area/indoors/town/rmh)
"W" = (
/obj/structure/bed/wool/double,
/obj/item/bedsheet/double_pelt,
/obj/machinery/light/fueled/wallfire/candle/l{
	pixel_y = 32
	},
/turf/open/floor/carpet/royalblack,
/area/indoors/town/rmh)
"X" = (
/turf/open/floor/twig,
/area/indoors/town/rmh)
"Y" = (
/turf/open/floor/rooftop,
/area/outdoors/rmh_air)
"Z" = (
/turf/closed/wall/mineral/roofwall/middle{
	dir = 8
	},
/area/indoors/town/rmh)

(1,1,1) = {"
F
a
a
F
a
a
F
"}
(2,1,1) = {"
a
W
q
h
e
c
a
"}
(3,1,1) = {"
U
r
l
F
R
P
G
"}
(4,1,1) = {"
y
p
z
O
i
t
a
"}
(5,1,1) = {"
y
V
T
R
R
P
G
"}
(6,1,1) = {"
y
K
J
R
k
B
a
"}
(7,1,1) = {"
F
a
A
C
h
a
F
"}

(1,1,2) = {"
H
N
Z
Z
Z
Q
Y
"}
(2,1,2) = {"
H
m
I
X
D
f
Y
"}
(3,1,2) = {"
H
m
X
X
X
f
Y
"}
(4,1,2) = {"
H
x
d
o
d
g
Y
"}
(5,1,2) = {"
s
m
S
S
S
f
Y
"}
(6,1,2) = {"
H
m
S
S
S
f
Y
"}
(7,1,2) = {"
H
L
u
u
u
b
Y
"}
