//MAP CONVERTED BY dmm2tgm.py THIS HEADER COMMENT PREVENTS RECONVERSION, DO NOT REMOVE
"a" = (
/turf/open/floor/metal/alt,
/area/under/town/rmh/basement/artificer)
"b" = (
/obj/structure/fluff/steamvent,
/turf/open/floor/metal/alt,
/area/under/town/rmh/basement/artificer)
"d" = (
/obj/structure/door/viewport{
	name = "Artificer's Private Lab";
	dir = 1;
	lockid = "mh_lab1"
	},
/turf/open/floor/concrete,
/area/under/town/rmh/basement/artificer)
"f" = (
/obj/machinery/light/fueled/torchholder/hotspring{
	pixel_x = -32
	},
/turf/open/floor/concrete,
/area/under/town/rmh/basement/artificer)
"o" = (
/obj/structure/fluff/steamvent,
/turf/open/floor/metal/barograte,
/area/under/town/rmh/basement/artificer)
"p" = (
/obj/machinery/light/fueled/torchholder/hotspring{
	pixel_x = 32
	},
/turf/open/floor/hexstone,
/area/under/town/rmh/basement/artificer)
"u" = (
/turf/closed/wall/mineral/craftstone,
/area/under/town/rmh/basement/artificer)
"A" = (
/turf/open/floor/concrete,
/area/under/town/rmh/basement/artificer)
"E" = (
/turf/closed/wall/mineral/stonebrick,
/area/under/town/rmh/basement/artificer)
"H" = (
/turf/open/floor/metal/barograte,
/area/under/town/rmh/basement/artificer)
"I" = (
/turf/open/floor/hexstone,
/area/under/town/rmh/basement/artificer)
"J" = (
/obj/machinery/light/fueled/torchholder/hotspring{
	pixel_x = -32
	},
/turf/open/floor/metal/alt,
/area/under/town/rmh/basement/artificer)
"L" = (
/obj/structure/handcart,
/turf/open/floor/concrete,
/area/under/town/rmh/basement/artificer)
"N" = (
/obj/structure/water_pipe,
/turf/closed/wall/mineral/pipe,
/area/under/town/rmh/basement/artificer)
"Q" = (
/turf/open/floor/metal/barograte/open,
/area/under/town/rmh/basement/artificer)
"R" = (
/obj/structure/fluff/steamvent,
/turf/open/floor/metal/barograte/open,
/area/under/town/rmh/basement/artificer)
"S" = (
/obj/structure/sign/property_sign/claim,
/turf/closed/wall/mineral/craftstone,
/area/under/town/rmh/basement/artificer)
"V" = (
/obj/structure/door/viewport{
	name = "Artificer's Private Lab";
	dir = 8;
	lockid = "mh_lab1"
	},
/obj/effect/mapping_helpers/access/locker,
/turf/open/floor/concrete,
/area/under/town/rmh/basement/artificer)

(1,1,1) = {"
E
A
A
A
A
A
E
u
"}
(2,1,1) = {"
f
A
Q
o
Q
H
J
u
"}
(3,1,1) = {"
L
Q
H
H
A
A
a
S
"}
(4,1,1) = {"
A
A
A
A
A
I
a
d
"}
(5,1,1) = {"
Q
H
R
A
I
I
a
u
"}
(6,1,1) = {"
I
I
Q
A
I
I
b
u
"}
(7,1,1) = {"
p
I
H
a
I
I
a
E
"}
(8,1,1) = {"
E
I
H
a
u
V
N
u
"}
